0,0,0,0,0,0,0,0,0,0,0,0,0,0,0,0,73,73,73
0,0,0,0,0,0,0,0,0,0,0,0,0,0,0,0,73,73,73
0,0,0,0,0,0,0,0,0,0,0,0,0,0,0,0,0,73,73
0,58,15,0,0,0,0,0,0,0,0,0,0,0,0,0,0,0,0
0,58,57,0,0,0,0,0,0,0,0,0,0,0,0,0,0,0,0
0,58,57,0,0,5,73,3,0,0,0,0,0,0,0,0,0,0,0
0,58,57,0,5,6,2,1,4,3,0,0,0,0,0,0,0,0,0
0,58,63,0,73,3,0,73,0,5,73,0,0,0,0,0,0,0,0
0,0,4,73,29,4,73,29,27,73,6,1,0,0,0,0,0,0,0
0,0,0,0,4,1,0,26,73,25,0,2,0,0,0,0,0,0,0
0,0,0,0,0,2,5,73,28,30,73,3,1,0,58,3,0,0,0
0,0,0,0,0,0,73,6,0,73,0,4,73,0,58,73,73,15,0
0,0,0,0,0,0,0,4,3,2,1,5,6,0,58,73,73,57,0
0,0,0,0,0,0,0,0,0,4,73,6,0,0,0,4,73,57,0
0,0,0,0,0,0,0,0,0,0,0,0,0,0,0,0,0,10,0
0,0,0,0,0,0,0,0,0,0,0,0,0,0,0,0,0,0,0
0,0,0,0,0,0,0,0,0,0,0,0,0,0,0,0,0,0,0
0,0,0,0,0,0,0,0,0,0,0,0,0,0,0,0,0,0,0
0,0,0,0,0,0,0,0,0,0,0,0,0,0,0,0,0,0,0
